Arrange similar words in English to one meaning 


Rude, rugged, Grainy, rough, brunt = kasar 

stubborn, air head = keras kepala.
 
stow, reserve = saving

demise, decease, mortality, dead = kematian

coffin = peti mati

dying = sekarat.

deceive, deceptive, swindle, swindler = penipu. 

deceiver = penipu.

sneak = menyelinap.

evoke, revive = membangkitkan.

rehearsal = latihan.

torture = penyiksaan. 

refine = repair.

abuse = penyalahgunaan.

deserve = layak.

fancy = menyukai (ke arah kemewahan).

surrender, concede = menyerah, mengakui

prevail = bertahan

wrestled = bergulat

beneath = dibawah 

notorious = terkenal 

dodge = menghindari 

relieve = meredahkan

scold = memarahi 

clumsy = kikuk 

plenty = banyak 

wimp = pengecut

witnesses = saksi 

tease = menggoda

divert = mengalihkan

jealous = cemburu

feesible = berbayar

incorporate = menyatukan

enforcing = menegakkan.

wisfull = sedih, dumps = kesedihan 

liar = pembohong

bid, offer, ofer = penawaran

densely = solid 

envoy = utusan

slam = membanting

shave = mencukur 

grave, cemeery = kuburan

bury = mengubur

fence = pagar 

rubble = reruntuhan

troops = pasukan

flee = kabur 

courage = keberanian

distinch, distinctive = different

outlier = orang asing 

pile = tumpukan 

envision = membanyangi 

insperable = dipisahkan 

adorable = menggemaskan

serene = tenang 

madness = kegilaan 

booed = dicemooh

drain = mengeringkan

renounce = meninggalkan

hectic = sibuk sekali

flushtered = resah 

overwhelmed = kewalahan 

fraternity = brotherhood

appropriate = sesuai 

grouchy = kesal

nude = telanjang

usual = biasa

unusual = tidak biasa

Collate = menyusun.

Crawl = merangkak 

delug = banjir.

considerably = sangat.

unrequited = tak berbalas. 

affront, hummilating = memalukan.

freebie = free

blush = memerah.

apparentely = rupanya, tampaknya

obviously = jelas

prettier = lebih cantik.

confuse = bingung.

sneeze = bersin.

fiance = tunangan. 

screw up = mengacau / mengganggu.

whimpers = merintih.

pit = whole

pitiful = kasihan.

manners = tata krama. 

retrieve = taking. 

cherist = pecinta.

maid = pembantu.

nail = paku.

cruise = pelayaran. 

wail = meratap.

amusing = menyenangkan. 

rave = sambutan hangat. 

raving = ocehan.

stab, ravishing = menusuk. 

infant = bayi. 

wild = liar.

unwild = bersantai.

thought = pikiran.

jealous = cemburu.
 
bellowing = berteriak.

recital = pertunjukan. 

stingks = menyengat.

silly = konyol.

dismiss = membubarkan.

stature = perawakan. 

somber = muram. 

soggy = basah. 

feesible = berbayar. 

incorporate = menyatukan. 

enforcing = menegakkan. 

wistfull = sedih. 

creek = sungai kecil. 

socks off = kaus kaki lepas. 

rustic = pedesaan. 

spawn = muncul.

nasty = tidak menyenangkan. 

clog = menyumbat.

maintain = menjaga.

doubt = ragu. 

confiscate = menyita.

bust = menyergap.

busting = pembobolan

remain = tetap.

shimmer = berkilau.

slope, ramp = lereng.

dumps = kesedihan.

intact = utuh.

eligible = memenuhi syarat.

scoffs = mengejek.

blaring = menggelegar. 

burial, funeral = pemakaman. 

tomb = makam

farewell = selamat tinggal. 

condolence = belasungkawa. 

honks = membunyikan klakson. 

firm = dengan tegas. 

replenishing = mengisi ulang. 

roding = berkuda. 

discard = membuang 

beaker = gelas kimia

curtain = tirai 

endeavour = berusaha keras

fleet = armada

strict = ketat 

propose = mengusulkan

proposed = diajukan

exquisite = sangat indah 

wedges = irisan

badge = lencana

appease = menenangkan

appeasement = penenang

rebuts = membantah

accusation = tuduhan

eradicate = memberantas 

condemn = mengutuk

demolition = pembongkaran

rebel = pemberontak

riot = kerusuhan

resist = against

resilience = ketangguhan

terminate = mengakhiri

friction = gesekan

immense, vast, wider, exent, spacious, widen, broader = sangat luas

drove = melaju

unwant = tidak menginginkan

impend = mengancam

repel = mengusir

raid = attack

avert = mencegah

rubber = karet.

reign = memerintah.

demon = setan.

beg = mengemis.

igniting = menyala.

spark = percikan.

resonate = menggema.

dignity = harga diri.

dig = menggali

salvation = penyelamatan.

exile = mengasingkan.

encounter = meet.

worship, adoration = memuja.

stare = menatap.

darn = menisik.

begotten = dilahirkan.

resurrect = menghidupkan kembali.

exalt = mengangungkan. 

sufficient = memadai.

affair = perselingkuhan.

dispose = membuang, disposer = pembuang.

joy = suka cita.

overdue = terlambat.

scarce = langka

scarcely = hampir tidak.

fracture = patah.

blew = meledak.

endure = menderita, bertahan

dure = tahan lama

upheaval = pergolakan.

turmoil = kekacauan.

renew = memperbarui.

enormous = luar biasa.

glimpse = sekilas.

lay = awam.

reconcile = mendamaikan

emits = memancarkan

plain = polos 

charm = pesona

take off = lepas landas

reliable = dapat diandalkan

liable = bertangung jawab

breach = melanggar

frothy = berbusa

freight = kargo

restrict, constraint = membatasi

indispensable = sangat diperlukan

intake = pemasukan

denounce = mencela

conduct = mengadakan

shame = malu 

secluded = terpencil

excusing = memaafkan

mat = tikar 

tun = penyetelan

extinguish = memadamkan.

preserve = melestarikan.

guilty = bersalah.

defendant = terdakwa

grief = duka

admire = mengagumi

retain = mempertahankan

override = mengesampingkan

agoniz = penderitaan

vows, pledge, oath, swarn = swear

curse = menyumpahi

confidential = layak

itinerary = rencana perjalanan

esteem = menghargai

amuse = menghibur

tidy, neat = rapi

finest = terbaik

laud = memuji

marinate = mengasingkan

laudable = terpuji

mediocre = biasa - biasa saja

horrendous = very bad

furnance = perapian

precise = tepat

endow = memberkati

abundant = melimpah

footage = rekaman

versatile = serbaguna

harmless = tidak berbahaya

ignite = menyalakan

wound = luka

slight = sedikit.

pour = menuangkan

lean = bersandar

retch, vomit = muntah

spews = memuntahkan 

itinerary = rencana perjalanan

buffer = penyangga

resend = kirim ulang

abundance = kelimpahan

bestow = giving

cease = stop

presence = kehadiran

mercy = belas kasihan

vivid = jelas 

slay = murder

slayer = murderer

surge = gelombang / melonjak

surgery = operasi

resistant = tahan

sweep = menyapu

barrage = rentetan

embark = starting

whiny = cengeng

abolish = menghapuskan

inappropriate = tidak pantas

undoubtedly = niscaya

scoundrel, scumbag = bajingan

crops = tanaman

luggage = bagasi

lumber = kayu

gulf = teluk

resilient = ulet

enroll = mendaftar

mandatory = wajib

rant = mengoceh

brag = membual

majestic = megah

rush = bergegas

unbearable = tak tertahankan

sequence = urutan

approach = mendekati

gibberish = omong kosong

regardless = tampa mempedulikan

lust = nafsu

suitor = peminang

suit = setelan

mutual = saling

haze = kabut

barr = penghalang

scrunize = meneliti

foster = membina / memelihara

grasp = mencengkram

resemble, embodied = similar

hoot = tiupan

bear = menanggung

beard = jenggot

bearded = berjanggut

rub = menggosok.

retain = mempertahankan.

magnificent = agung

assemble = berkumpul.

jerk = bajingan.

sob, weep = cry

tick = kutu

survaillance = pegawasan.

burden = beban

adultery = zina 

choir = paduan suara

soothe = menegangkan

rejevenate = meremajakan

corner = sudut 

mobbed = dikerumuni

revendication = balas dendam.

naked = telanjang.

abducted = diculik.

elderly = tua

freed = dibebaskan

captive = tawanan

unpacked = dibongkar

barring = halangan

vantage = menguntungkan

expels = mengusir

apostate = murtad 

abandon = leave

heat = panas.

condemn = memvonis.

bow = membungkuk

wag = mengibaskan.

feather = bulu

featherless = tidak berbulu.

faithfulness = kesetiaan

rampart, fortress, citadel = benteng 

void = ruang kosong

devoid = without

reinvorce = bercerai kembali

vacant = kosong.

revival = kebangkitan

prosecute = menuntut

vest = rompi

captivity = tahanan

hook = kait

wavy = bergelombang

divest = melepaskan

rally = rapat umum 

ramp up = increase

expulsion = pengusiran

suspension = penangguhan

sever = decide

overust = berlebihan

bail = jaminan

settler = pendatang

municipal = city

unearthing = menggali

plunded = dijarah

confiscation = penyitaan

dozen = lusin

vicinity = sekitarnya 

discouraging = mengecewakan

kit = perlengkapan

uneasy = gelisah

truce, armistice = cease fire

detain = menahan

waiver = pengabaian.

avenge = membalas.

unbearable = tak tertahankan.

arrest, seize = catch.

encampment = perkemahan.

surge = lonjakan 

former = mantan

formed = dibentuk

finesh = terbaik

mobbing = pengeroyokan

chase = mengejar

incessantly = tampa henti

prospective = calon

bride = pengantin perempuan

deduct = mengurangi

aim = tujuan

inadequate = tidak memadai

depict, portray = draw

humid = lembab

greedy = serakah

wellness = Kesehatan

approach = mendekati

drill = mengebor

attain = achieve

arrival = kedatangan 

adjust = menyesuaikan

disagrace = aib

dishonoring = tidak menghormati

ammase = mempermalukan

merely = hanya

grant = blessing

tallied = dihitung

drawer = laci

occupant = penghuni

prosper, prosperous = Makmur

nuke = senjata nuklir

haggle = tawar-menawar

inappropriately = tidak pantas

tend = cenderung

overlap = tumpang tindih

disturbance = gangguan

nurture = pengasuhan

decay = membusuk

imprison = memenjarakan

exile = mengasingkan

convey = mengangkut

sleeve = lengan baju.

upon = pada.

colloquial = Bahasa sehari - hari

consideration = pertimbangan

needle = jarum

cutleries = peralatan makan

disposable = sekali pakai

vying = berlomba -lomba

rural = pedesaan

urban = perkotaan

apetite = nafsu makan

torn = robek

weave = menenun 

vengeance = pembalasan

breakable = mudah pecah

massacre = pembantaian

rescind = cancel

devastating = broke

seamless = mulus

seam = lapisan

prompt = mengingatkan, promptly = tepat

garner = mengumpulkan

redemption = penebusan

remembrance = ingatan

mock, humiliate = menghina

insist = bersikeras

annihilate = membinasakan

compromise = kompromi

stupendous = menakjubkan

trail = jejak 

wander = berjalan - jalan

jaundice = penyakit kuning 

apocalypse = kiamat

whittle = mengurangi

comply = mematuhi

confess = mengakui

relief = lega

siege = pengepungan

raped = diperkosa.

govern = memerintah.

acknowledgement = pengakuan.

devoted = setia.

biased = berat sebelah

amusement = hiburan

exact = akurat

laced = bertali

dehumanizing = tidak manusiawi

glorifying = memuliakan

onslaught = serangan gencar

grip = pengangan

anthem = lagu kebangsaan

unabashedly = tampa malu-malu

vengeful = penuh dendam

besiege = mengepung

incite, incites = menghasut, incitement = hasutan,

pebble = kerikil

meantime = sementara itu

regard = pandangan

stagger = sempoyongan

wound up = berakhir 

roughly = dengan kasar

sway = bergoyang

fizzle = kebingungan 

orphans = anak Yatim pintu

smuggle = penyeludupan

ripples = riak

grassroots = akar rumput

disregarding = mengabaikan

behead = memenggal kepala

derail = menggelincirkan

ironclad = strong 

alter = change

favor = kebaikan

induce = menyebabkan

indivisible = tak terpisahkan.

amid = tengah.

lagged = tertinggal.

predecessor = pendahulu.

unveiled = diresmikan.

stipulated = ditetapkan.

numerous = banyak sekali.

stance = pendirian.

loose = longgar

accession = achievement

enlargement = pembesaran

steer = mengarahkan

council = dewan

truce = ceasefire

chill = santai

halt = stop

imminent = near

viable = giat, layak

refrain = menahan diri

nevertheless = namun demikian

coincided = bertepatan

enlargement = pembesaran

acceding = mengakses

cooperated = bekerja sama

reinforced = diperkuat

preparedness = kesiapan

stumble = tersandung

tumble = jatuh

reforms = reformasi

subsequent = setelah 

alongside = disamping

deter = menghalangi

petrifying = helping

stationed = ditempatkan

vulnerable = rentan

tremendous = luar biasa

consists of = terdiri dari

complicit = involve

unfettered = tidak terkekang

fiercest = paling sengit

fierce = garang

conceal = menutupi

unanimous = agree 

ought = reverse

attach = menempel

ascension = kenaikan

grimp = suram

inaction = lambat

gauge = mengukur

tribal = kesukuan 

rapture = pengangkatan

escalate = meningkatkan

subservient = tunduk 

reprimand = teguran 

pretext = dalih 

inaudible = tidak terdengar

hostility = permusuhan

shunning = menghindari

outrage = kebiadaban

inception = birth

exaggerates = melebihkan

sled = kereta luncur

rebuke = menegur

shred = sobekan

inflicting = menimbulkan

planaries = pesawat terbang 

refute = menyangkal

jeopardize, insidious, malicious = danger

fascination = mempesona

apparently = tampaknya

dispossess = mengusir

convince = menyakinkan

alleged = dugaan

dissuade = menghalangi

heck = sial

heckled = dicela

bereaved = berduka

tacit = diam - diam

fitting = tepat

flame = fire

bravest = paling berani

incisive = tajam

subtract = mengurangi

chore = pekerjaan rumah

debunk = membantah

interlude = selingan 

raw = mentah

restrined = terkendali

recount = mengingat 

dock = dermaga

deteriorate = memburuk

dire = terrible

rebuke = menegur

fizzle out = fail

jeering = mengejek

slate = batu tulis

gruel = bubur

grue = terribe

evade = menghindar

detach = melepaskan

fellow = rekan

mockery = ejekan

unpredecented = belum pernah terjadi sebelumnya

inmates = terkepung

extermination = pemusnahan

agony, miserable = pain

bloodshed = pertumpahan darah

steadfast = tabah

elevate = mengangkat

compassion, affection, darling = kasih sayang.

bridging = menjembatani.

farthest = terjauh.

antithetical = bertentangan

altered = diubah

regain = back.

statehood = kenegaraan

armistice = genjatan

rift = keretakan

cage = kurungan 

resurrection = kebangkitan

bribe = menyuap

escort = pengawal

derived = berasal dari

disburse = get out

preaching = khutbah

preacher = pengkhotbah

ostracize = mengucilkan

abide = tinggal

abiding = kekal

obligate = wajib 

reiterate = repeat
 
imposing = mengesankan

clambering = memanjat

remnant = sisa

impose = memaksakan

catastrophic = bencana

viable = diligent

due to, hence = because of 

blatant= menyolok

leap, leapfrog = melompati

perceive = see

emphasis = pressure

pure = murni

perseverence = tekun

severe = berat

slack = kendur

clerk = staff

tickle = menggelitik

approach = mendekati

frugal = hemat

hang = mengantung

tent = tenda

unveiling = opener

wrath = anger

butcher = tukang daging

cease = berhenti

mourn = meratapi

prejudice = prasangka

attempt = percobaan

preeminent = unggul

spat = bertengkar

nephew = keponakan laki - laki

torment = menyiksa

span = menjangkau

penned = ditulis

necklace = kalung

priest = pendeta

bishop = uskup

stall = macet

labor = tenaga kerja

rigorous = keras, teliti,ketat

bias = berat sebelah.

babysit = mengasuh anak.

reimbursement = return, penggantian biaya

saturate = jenuh

upheld = ditegakkan

held = ditahan

carry out = bring

circumstate = keadaan

remedy = fixing

repenion = penyesalan

stakes = taruhan

disastrous = bencana

dubious = meragukan

closure = penutup

foggy = berkabut

dams = bendungan

ongoing = sedang berlangsung

staunch = setia

assess = menilai

relentless = tampa henti 

carelessness = kecerobohan

licking = menjilati

dissuade = menghalangi

blunt = tumpul

fidelity = kesetiaan

crusader = tentara salib

schism = perpecahan

hail = calling

monk = biarawan.

infallible = perfect.

supreme = tertinggi

apostle = rasul 

penance = penebusan dosa 

anointing = pengurapan

matrimony = perkawinan

salvation = penyelamatan

grace = berkah

priesthood = imamat

marvelous = menakjubkan

derive = memperoleh

devotion = kesetiaan

reverence = menghormati

conceive = understand

immaculate = sangat rapi

decry = mengutus 

assembly = perakitan

crook = bastard

nudge = dorongan

fragrance = wangi, fragrances = wewangian

recur = terulang

feverish = panas

dim = redup

pummel = pounch

exacerbate = memperburuk

pundit = cendekiawan

rage = mengamuk

disengagement = pelepasan

occurrence = kejadian

wet = basah

wetland = tanah basah

revolt = memberontak

blantant = mencolok

tangible = real

leak = bocor

persecution = penganiayaan

chant = nyanyian

defund = mencairkan dana

sane = waras

monstrosity = keburukan

decency = kesopanan

leaflet = selebaran

sweat = keringat

trench, ditch = parit 

ceil = langit - langit

reduce = mengurangi

stationed = ditempatkan

grace = berkah 

ambush = penyergapan

shovel, spade = sekop 

shove = mendorong

invicible = tak terkalahkan

dismantle = membongkar

nap = tidur

drifted off = melayang

ancestral = ancestor

vicinity = sekitarnya

wrap = membungkus

throne = takhta

ducked = merunduk

comrade = kawan

surreal = nyata 

humiliate = menghina 

unconscious = tidak sadar

valve = katup

shoreline = garis pantai

reside = tinggal 

unsure = tidak yakin

enforce = melaksanakan

rear = behind

tend = cenderung

rang = berdering

mild = soft

fiery = berapi

excite = merangsang

pitch = melempar

beacon = suar

twisted = memutarbalikkan

sanity = kewarasan

cripple = lumpuh

dubble = dijuluki

untie = open

sinful = dosa

residing = berada

intermingle = memperkacaukan

mingle = membaur

idly = iseng 

hilarious = lucu sekali

enmity = permusuhan

insult = menyinggung

foresaw = meramalkan

rigity = kekakuan 

offended = tersinggung

devotion = kesetiaan

profound = menonjol

disdain = penghinaan

disgust = menjijikan

urge = keinginan

slave = Budak, enslave = memperbudak, slavery, bondage = perbudakan

laureates = pemenang hadiah

pretty = cantik

foremous = important

wagging = mengibas

convict = menghukum 

rifle = senapan

deviant = menyimpang

despicable = tercela 

defies = menentang

defy = menentang

smelt = berbau 

martyrs = para martir

vortex = pusaran

obscures = mengaburkan

devise = merancang

quotation = kutipan

henchman, stooge = antek

lack = kekurangan

naughty = nakal

unbothered = tidak diganggu

scavenger = pemulung

afoul = bertabrakan

nest = sarang

emerge = appear

tense = tegang

tuition = biaya Pendidikan

modest = sederhana

shed = Gudang 

aging = penuaan

curb = rule

regard = pandangan

wire = kabel

disperse = membubarkan

dispersed = tersebar

tire = ban 

soak = basah

thug = penjahat
 
teen = remaja

rascal = bajingan

mop = mengepel 

dizzy = pusing

retract = menarik

pursue = mengejar

leash = rope

cleric = ulama

yel = teriak

bump = menabrak

sternly = firmly

beetles = kumbang

willed  = berkehendak

slipper = sandal

ace = kartu as

sulk = merajuk 

astray = sesat

puddle = genangan air

slander = fitnah

hedgehog = landak

hedge = pagar

agonize = menderita

dignitate = bermartabat

pope, pontiff = paus. pontification = kepausan

bummed = kecewa

confession = pengakuan

crush = menghancurkan

taited = tercemar

hallway = lorong

superstition = takhayul

acquainted = berkenalan

forger = pemalsuan

sober = tidak mabuk

providence = penyediaan

buzzle = desas - desus

slump = kemerosotan

slum = daerah kumuh

delated = kempes

tear = merobek

witch = penyihir 

orphage = panti asuhan

behave = berprilaku baik

frankly = terus-terang

gulls = burung camar

squawking = mengoceh

indistinctly = tidak jelas

thump = berdebar

dormant = terbengkalai

extinction = kepunahan

fend = menangkis

howl = melolong

trespassing = masuk tampa izin 

blanket = selimut

depend = bergantung

sanctuary = suaka / tempat perlindungan

graze = tergores

foreseen = diramalkan

consciousness = kesadaran 

adore = love

trace = jejak

concrete = konkret

perishable = fana

perish = binasa

maze = labirin

shaky = goyah

dispatch = menugaskan

mandatory = wajib

cushy = enak

gig = dokar

lane = jalur

enchantment = pesona

bat = kelelawar

brake = rem

precarious = genting

growl = menggeram

disembowel = mengeluarkan isi perut

swarm = kawanan 

strain = tekanan

accord, accordance = sesuai 

landmines = ranjau darat

infuriate = memanaskan

merrier = lebih meriah

proper = sesuai

widow = janda

curable = dapat disembuhkan

arbitarian = sewenang - wenang

tempt = menggoda

temptation = godaan

clay = tanah liat

evidence = bukti

bargain = tawar - menaar

defies = menentang

disobedience = membangkang 

loot = menjarah

charred = hangus

fleas = kutu

corpses = mayat

bleach = pemutih

vain = sia - sia

stain = noda

tacky = norak

surgical = bedah 

munitions = amunisi

favourable = good 

devour = melahap 

defiant = menantang

defiance = tantangan

dormitory = asrama

pump = pompa

resistance = perlawanan

precedence = hak lebih tinggi

precede = mendahului / before

urgue = mendesak

morn = pagi

hush = silince

case = kasus

shatter = break

unfold = open

nanny = pengasuh

allowance = uang saku

falsified = dipalsukan

orphanage = panti asuhan

trove = harta karun

louge = big

wield, exert = using

disrection = kebijaksanaan

vintage = antik

buster = penghancur

feeder = pengumpan

comprise = meliputi

concise = ringkas

vague = tidak jelas / samar

reap = menuai

verdict = dakwaan

blast = ledakan

rigged = manipulated

slap = menampar

divinity = keilahian 

pilgrim = peziarah 

broaden = memperluas

broad = lulus

nurturing = pengasuhan

incubation = inkubasi

toddlers = balita

ripe = matang

shone =bersinar

disgrace = aib

engulf = menelan

beware of = hati - hati terhadap

sue = menuntut

heed = mengindahkan

maternity = bersalin 

piercing = tajam

giggling = cekikikan 

ensue = terjadi 

hijiks = pesta pora

shiver = menggigil

dripping = menetes 

bald = botak

repent = menyesali

strangle = mencekik

miserly = kikir 

penniless = miskin 

attorney = pengacara

repay = membayar Kembali

neck = leher

dusty = berdebu

dick = kontol

yapping = omong kosong

drowsiness = kantuk 

reek, stench = bau

reflux = surutnya

relenthlessly = tampa henti

stiff = kaku

neither = juga tidak

theif = pecurian

inherent = sifat yang permanen

chaotic = kacau

egregious, horrifying, appalling, terrible, creepy = horrible

shook = bergetar

cringe = jijik, ngeri

dissent = perbedaan pendapat

suffocate = mati lemas

agitate = mengganggu

barged = menerobos

assert = menegaskan 

sleve = lengan baju

strand = untaian

owe = debt

ashore = ke darat

detonate = meledakkan

wreach = kejahatan

led = dipimpin

envelope = amplop

sank = tenggelam

contingency = kemungkinan

rig = peralatan

canard = desas - desus

beam = balok

fuselage = badan pesawat

lure = memancing

sink = tenggelam 

ejected = expelled

lever = tuas

ejection = penyemburan

vigilant = waspada 

blatant = menyolok

grudge = sakit hati

torment = menyiksa

quintessential = paling mewakili

quintuplets = kembar lima

briefly = secara singkat

raven = gagak

afflict = menimpa

hollow = empty 

reaper = mesin penuai

whisper = bisikan

surgeon = ahli bedah 

reignites = menyala Kembali

seagull = camar

pickle = acar 

condiment = bumbu

fart = kentut

scurry = bergegas

gloat = melihat dengan tamak

demeaning = merendahkan

restless = gelisah

harbinger = pertanda

apocalypse = wahyu

leather = skin

suede = kulit lunak

rubbist = tukang sampah

grost = kotor

fudge = berbuat curang

rewind = memutar ulang

preservation = kelestarian

tingly = geli

banish = membuang

stranded = terdampar

grease = gemuk

blow = meniup

pawn = bidak

nefarious = jahat

upset = gudah

lick = menjilat

ambience = suasana

scarcity = kelangkaan

whump = cambuk

mate = pasangan

clingy = tergantung

cling = melekat

giggle = cekikikan

wiggle = menggoyangkan 

pouch = kantong

pun = permainan kata - kata

wink = mengedip

weasel = musang 

dazzle = mempesona 

reassure = meyakinkan

assure = menjamin

glide = meluncur

implause = alasan

turd = kotoran

wittle = lemah 

rabid = fanatik

arsonist = pelaku pembakaran 

gravy = saus 

lift = mengangkat

vent = lubang angin

hatch = menetas 

shrimp = udang

hail = call

chatter = mengobrol

weary = Lelah 

shed, ware = Gudang

caught = tertangkap

bizzare, whimsical, queer, outlandish = weird

wilderness = gurun 

straight = lurus

treason = betray

hindrance = halangan

disarm = melucuti senjata

bloodbath = pertumpahan darah

inquire = menanyakan

carnage = pembantaian

mortgage = hipotek

spill = tumpahan

slush = lumpur salju

chubby = tembam

faint = pingsan

sully = menodai

alley = gang

gestation = kehamilan

sorrow = duka

sorrowfully = dengan sedih

devience = penyimpangan

pant = celana

burst = Meletus

decade = dasawarsa

plead = mengaku 

fed = diberi makan

thingy = benda

moan = mendesah

muffle = meredam

succumb = menyerah 

such = menyelinap

delighted = senang sekali 

distort = memutarbalikkan

slim = langsing

woes = menyengsarakan

rampant = merajalela

deprive = mencabut / merampas

limb = lengan

roast = memanggang

deed = perbuatan 

dollet = boneka 

wage = salary

suffocate = mati lemas

seagull = camar

squirrel = tupai

lynched = digantung 

purity = kemurnian

guerillas = gerilyawan

forecast = ramalan

tailor = penjahit

fortitude = ketabahan

sincerity = kejujuran

cavity = rongga

deception = tipu daya

frenzy = hiruk - pikuk

snort = mendengus

rein = kendali

snarts = mendengus

thudding = berdebar

surging = bergelombang

horn = tanduk

commence = starting

inquisitive = ingin tahu

veil = kerudung

sniping = menembak 

behave = berperilaku baik

treat = care 

freest = paling bebas

shipwreck = kecelakaan kapal

blinken = berkedip

pilgrimage = ziarah

reluctant = enggan

demigod = dewa setengah dewa

bumpy = benjolan

reef = karang

snoring = keruh

surreality = kenyataan

flint = batu api

flinty = keras 

loaf = roti

savant = sarjana

rattle = berdetak 

depleted = habis 

hasty = gegabah

rid = menyingkirkan

clue = petunjuk

depravity = kebejatan

adversity = kesulitan

weaver = penenun

freak = orang aneh

lair = sarang

bush = semak - semak 

feast = pesta

fickle = berubah - ubah

entourage = rombongan

humming = bersandung

urchin = landak 

jangle = membunyikan

drool = ngiler

puffer fish = ikan buntal

huffed = mendengus

sledding = meluncur

fishy = mencurigakan 

Coy = malu - malu

stuffed = diisi, stuffing = isian

lad = anak laki - laki

waver, falter = bimbang 

crappy = jelek

crap = omong kosong

axe = ship

wielding = memegang

plea = permohonan

critter = makhluk 

dome = kuba

fella = friend 

revile = mencaci

vile = keji

covet = adding

coveted = didambakan

exhalarating = menggembirakan

unwind = resting

pamper = terlalu memanjakan

breeze = angin-semilir

clash = bentrokan

detrimental = merugikan

jaws = rahang

terrain = medan

teamed = bekerja sama

scapegoated = dikambing hitamkan

sanctity = kesucian

doom = malapetaka

blister = melepuh

fiddle = biola

sheath = sarung 

durable = tahan-lama


groom = pengantin pria

lament = meratapi

lame, flawed = cacat

unease = kegelisahan

suitcase = koper

saint = santo

perseverance = kegigihan

mirage = fatamorgana

ladder = stairs

agape = ternganga

kneel = berlutut

cheek = pipi

slain = murdered

disarmament = pelucutan senjata

bagging = mengantongi

deescalate = mengurangi ketegangan

distinction = perbedaan

solely = semata-mata

relay = menyampaikan

pardon = sorry

lured = terpikat

grieve = bersedih

lousty = buruk

companion = pendamping

awful = buruk sekali

exceed = melampaui

bulk = dalam jumlah besar

intriguing = membuat penasaran

yawn = menguap

crave = mendambakan

dive = menyelam

backbone = tulang punggung

ratchet = roda bergigi searah

handily = dengan muda

concocted = dibuat

amass = mengumpulkan

exceptional = luar biasa

heist = perampokan

taint = noda

strait = selat

adolescent = remaja

blind = buta

dusk = senja

forte = keahlian

budding = pemula

boast = membanggakan

valet = pelayan 

assuring = meyakinkan

nod = anggukan.

blink = berkedip

outdo = mengalahkan

bluff = menggertak

clueless = tak tahu apa-apa

sly = licik

butt = pantat

glance = lirikan

reckless  = ceroboh, gegabah

lanky = kurus

sprout = tumbuh

sudden = tiba - tiba

mooch = steal

scouted = dibina

hassle = kerepotan

entice = interesting

inkling = firasat

dope = bagus sekali

convoluted = membelit

decent = baik

glare = silau

cheer = bersorak

attire = pakaian 

relieve = lega

decoy = umpan

retaliate = membalas

irreversible = tidak dapat diubah

excitement = kegembiraan

leech = lintah

immersive = melingkupi

fame = popularitas

peculiar = aneh 

fledgling = seed

brew = seduhan

prevalent = lazim

bragg = membual

uncage = membuka sangkar

cottage = pondok

assembled = berkumpul

shread = benang

plunge = terjun

adverse = merugikan

turmoil = kekacauan 

cop = police

bedridden = terbaring ditempat tidur

bend = membengkokkan

devastated = dihancurkan

compensate = mengimbangi

yield = earning

cringing = merasa ngeri

forged = ditempa 

forgery = pemalsuan

tweak = cubit 

moldy = berjamur

acquire = mendapatkan

impaired = terganggu

elated = gembira

exciting = seru

infringe = melanggar

infringement = pelanggaran

petty = cerewet

racking = memeras

glutton = pelahap

renewal = pembaruan

trouser = celana Panjang 

appraisal = penilaian 

humiliate = menghina

baldness = kebotakan 
 
hip = panggul 

fussy = cerewet

trembling = gemetaran

spilling = tumpah

severance = pemutusan

cog = teeth

doomsday = kiamat

plumb = tegak lurus

discourage = mengecilkan hati

indulge = memanjakan  

fledge = menjadi dewasa / matang

entanglement = keterlibatan 

plunder = menjarah

surveil = pengawasan

strive = berjuang

womb = Rahim

intertwined = terjalin

armed = bersenjata

humidifier = pelembab

tidings = news

preceded = sebelumnya

cultivate = mengelolah

rescinded = canceled

cater = serve

extinch = padam

undergo = menjalani

riveting = interesting

backlogged = tertinggal

endued = tertinggal

admonition = peringatan 

confine = membatasi

witches = penyihir

counsel = nasihat

wisest = paling bijaksana

mundane = biasa

dwarf = kerdil

deem = menganggap

advisable = sebaiknya.

fraudulent = curang.

lease = rent.

serenity = ketenangan.

subordinate = bawahan

cuffing = memborgol.

thrilled = sangat senang.

flagged = ditandai.

scattered = berserakan.

deterred = terhalang.

brace = menahan

bracelet = gelang.

designates = menunjuk 

worse = lebih buruk

ashes = abu

defecet = dirusak

ubiquitous = dimana-mana

decline = deny

stringent = ketat

exceeding = melebihi

feat = prestasi

renowed = terkenal

palsy = kelumpuhan

advert = iklan

barred = dilarang

bigory = kefanatikan

furtive = sembunyi

reek = bau

grandiose = muluk

revoke = menarik Kembali

fury = angry

sincere = honest

struck = dihantam

scour = discovery

ablution = pembersihan

salutation = sapaan

adherence = ketaatan

adhering = melekat

whilst = sementara

caliphate = khalifah

incorporated = tergabung

dimmer = lampu dim

glitch = mistake

discontinue = menghentikan

shade = naungan

curfew = jam-malam

disservice = Tindakan merugikan

prone = rentan

fatten = menggemukkan

supine = terlentang

predisposed = cenderung

substances = zat

encased = terbungkus

rejuvenate = meremajakan

embalm = membalsem

amulets = jimat

curses = kutukan

charms = pesona

dwindled = menyusut

dwindling = merosot

nonsense = omong kosong

insensitive = tidak peka

senseless = stupid

pseudonym = nama samaran

churning out = berputar keluar

priceless = sangat Berharga

valued = bernilai

pleaded = memohon

brink = tepi jurang / ambang batas

rambling = bertele - tele

stutter = gagap 

conviction = pengakuan

grudges = dendam

rehearse = exercise

flirting = menggoda

board  = papan

purge = cleaning

oversee = mengawasi

emerged = appear

bare = empty

barely = nyaris

bribe = menyuap

beleaguer = mengepung

vested = berada ditangan

commend = memuji

spree = kesenangan

deterrence = prevent

tangle = menjerat 

shelled = dikupas

tailored = disesuaikan

inclusion = penyertaan

dent = lekuk

tranquility = ketenangan

forming = membentuk 

overlaid = dilapis

warehouse = Gudang

enlisting = mendaftar

ovation = tepuk tangan meriah

abort = cancel

uphold = menegakkan

diminish = reduce

warfare = war

combatant = pejuang

utter = mengucapkan 

casualties = korban jiwa

desecrating = menodai

distinguish = membedakan

despicable = tercela 

torch = obor

deprecated = tidak digunakan lagi

ambiguous = ambigu

grander = lebih agung

covenant, treaty = agreement

bearing = menanggung

renown = ketenaran

nauseating = memuakkan

term = ketentuan

precaution = Tindakan pencegahan

effigy = patung

sour = masam 

numb = mati rasa

ticking = berdetak 

unconscionable = tidak masuk akal 

absentee = absen 

jolt = goncangan

plight = keadaan sulit 

unthinkable = tak terpikirkan

exclude = mengecualikan 

inking = tinta

intertwined = terjalin 

bind = mengikat

cult = kultus

dangle = menggantung

retailed = menjual eceran

pave = mengaspal

begets = melahirkan 

congregation = jemaat

dwell = berdiam

denance = penolakan

occupancy = hunian

decreed = ditetapkan

glorified = dimuliakan

plausible = masuk akal

implausible = tidak masuk akal

shed = Gudang

slammer = penjara

dungeon = penjara Bawah tanah

coincidence = kebetulan

rolled out = diluncurkan

perpetrate = doing

shill = penjaja

lantern = lentera

whine = merengek 

enrich = memperkaya

goose = angsa

heal = menyembuhkan

infamy = aib

constrictor = pembatas

serpent = snake

crunch = kegentingan

creed = keyakinan

indomitable = gigih

rapist = pemerkosa

latch = memalangi

attic = loteng

crane = derek 

disseminate, proliferation = spread 

ensuing = happened

atrocities = kekejaman

pertaining = berkaitan

impunity = impunitas

intack = attacking

mend = fixing

allegation = accuse

spanked = punched

inquiry = asking

interlock = berpaut

scrutiny = pemeriksaan

emphasize = menekankan

graceful = anggun

disgraceful = shamefully

despise = hate

depiction = penggambaran

divisive = memecah belah

trivia = hal sepele

trivialize = meremehkan

stick = tongkat

vividly = clearly

dastardly = keji 

deliberately = sengaja

deductible = dapat dikurangi

stave = menahan

stalk = menguntit

enraged, fumes, resentful, incensed = angry

adjudicate = mengadili

embrace = merangkul

shedding = melepaskan

villain = penjahat

disintegration = disentegrasi

reminisce = mengenang

reminiscent = remember

vacuous = hampa

tranquilize = menenangkang

salvage = saving

finate = limited

waxed = menjadi pucat, dipoles

gaunt = kurus kering

endurance = ketahanan

indecency = ketidaksenonohan

wicked = evil

wickedness = kejahatan

erode = mengikis

entitled = berhak

pronged = bercabang

intricacies = kerumitan

conversely = sebaliknya

animosity = kebencian

spine = tulang belakang

shrapnel = pecahan peluru

retaliation = revenge

upstaged = dikalahkan

suburb = penggiran kota

labour = buruh 

hostile = bermusuhan

wein = anggur

sheer = thin

vicious = ganas

sculpture = patung

abdicates = turun tahta

scrambling = berebut

audacious, nerve, daring, dared, gutsy, daredevil = brave

exorbitant = berlebihan

scorch = menghanguskan

prominence = keunggulan

subordinance = subordinasi

commemorate = memperingati

adjustment = rule

cautiously = dengan hati-hati

prominent = menonjol

injected = disuntik

beseech = hoping

inauguration = pelantikan

amplify, bolster = memperkuat

ramification =  konsekuensi

inflammatory = menghasut

caterers = catering

gear = perlengkapan

geared = diarahkan

allegedly = diduga

bribery = penyuapan

encompass = meliputi

flailing = menggagalkan

canned = dikalengkan

foetus = janin

flagrant = mencolok

devoutly = dengan taat

probed = menyelidiki

traverse = melintasi

inscribed = tertulis

scholars = ulama

apportionment = pembagian

interminable = tak berkesudahan

repentance = pertobatan

futility = kegagalan

flock = kawanan

stead = benefit

offset = mengimbangi

guise = samaran

unjustly = secara tidak adil

decked = dihiasi

hosting = menjamu 

cue = isyarat

presumably = agaknya 

starve = kelaparan 

cure = menyembuhkan

lung = paru - paru

efficacy = kemanjuran 

keen = tajam, like 

queries = pertanyaan 

alleviate = meringankan 

sophisticated = canggih 

elaborate = rumit

detour = jalan memutar

whirl = berputar

negligible = dapat diabaikan

inducement = bujukan

conjuration = ramalan

rage = kemarahan

formidable = great

warm = melengkung

befall = menimpa

pissed = kesal

resentment = kebencian

nipples = putting susu

galore = berlimpah

heinous = kejam 

stun = mengejutkan 

belligerent = suka berperang

cohesive = kompak

oust = expel

disbanned = bubar

insufficient = not enough

revelation = wahyu

reinstate = mengembalikan

lessen = reduce

sincerely = dengan tulus

eager = bersemangat

incorporeal = tidak berwujud

immutable = kekal

omniscient = maha tahu

hauling = pengangkutan

disguise = samaran

deification = pendewaan

congestion = kemacetan

municipality = kotamadya

idle = menganggur

quibble = pertengkaran

portrayal = penggambaran

spouse = couple

disparity = difference

provost = rektor

compliance = kepatuhan 

inaugural = perdana

robust = kokoh

honing = mengasah

tangent = garis singgung

vary = bervariasi

inrush = arus masuk

apprenticeship = pemagangan

incursion = attack

skews = miring

majeure = yang besar

perpetuate = mengabadikan

frantic = panik

robe = jubah

daunting = menakutkan 

comb = sisir

knack = keterampilan

gut = keberanian

greenery = tanaman hijau

lawn = halaman rumput

finctional = fiksi

bedding = seperai

household = rumah tangga

drought = kekeringan

recoil, retreat = mundur

encroaching = merambah

unravel = mengurai 

binder = pengikat

barn = lumbung

inevitable = tak terelakkan

rigidity = kekakuan

wracking = menyiksa

welfare = prosperous

genuine = original

wrangle = bertengkar

chamber = room

dissed = ditolak

fairest = tercantik

defiator = pembangkang

gaze = tatapan

tavern = kedai minuman

quarry = tambang 

bucket = keranjang

prune = pangkas

abundantly = berlimpah

COMPULSORY = wajib

ease = kemudahan

scream = berteriak

fastidious = rewel

maiden = gadis

sorcerer = penyihir 

cloak = jubah

broadsword =  pedang lebar

saturation = kejenuhan

urge = dorongan

pescatarian = orang yang suka makan ikan

swamp = rawa

dissect = membedah

craft = kerajinan

flawlessy = perfect

accustom = membiasakan

confussion = kebingungan

severity = tingkat keparahan

obidients = orang yang taat 

snitch = mengadu

muddy = berlumpur

ultimately = akhirnya

quail = burung puyuh 

offense = pelanggaran

tedious = membosankan

implode = meledak

menace = thread

mustache = kumis

suffocation = mati lemas

deity = dewa

wedlock = ikatan pernikahan

rusty = berkarat

uproar = keributan

culprit = pelaku

wrecked = hancur

wreck = accident

thicky = bold

sore = sick

sicken = jatuh sakit

ruthless = kejam

nimble = lincah

burrow = liang

lurk = mengintai

clanking = berdenting

enact = menetapkan

tabulate = tabulasi

veer = membelok

ignorant = kurang pengetahuan

charter = piagam

outward = luar

acquintance = kenalan

brimmed = bertepi

askew = miring

abandoned = ditinggalkan

seduce = menggoda

enchanted = terpesona

submersible = dapat tenggelam

dice = dadu

silhouette = bayangan hitam

enchanting = mempesona

perverted = sesat

gills = insang

apostolic = kerosulan

pointificate = kepausan

apostasy = kemurtadan

modesty = kerendahan hati

dean = dekan

pious = saleh

ascribe = menganggap

garb = clothes

atonement = penebusan dosa

recite = membacakan

prescribe = meresepkan

lurgical = bedah

purgatory = api penyucian

pontificate = kepausan

superb = luar biasa

vault = brankas

fugitive = buronan

casting = pengecoran

nets = jaring

sow = menabur

allure = daya Tarik

flourish = berkembang

charged = dibebankan

evasion = penghindaran

waded = mengarungi

ledge = langkan 

shaft = poros

chimney = cerobong asap

allinated = terasing

lavish = luxury

climate = iklim

hesitate = ragu-ragu

convection = konveksi

verge = tepi

lounge = ruang santai

berth = tempat santai

pedigree = silsilah

decipher = menguraikan

puke = muntah

drake = itik jantan

chopping = memotong

puny = small

relish = menikmati

commotage = makanan lezat 

sanctum = tempat suci

dread = menakutkan

intricate = rumit

munch = mengunyah

excerpt = kutipan

excessive = berlebihan

yanked = menarik

dove = merpati

sack = memecat

knuckle = kuku jari

subtle = soft

grassy = berumput

comprises = terdiri

steep = curam

coastal = pesisir

cliffs = tebing

merit = jasa

merits = kelebihan

subset = bagian himpunan

desirable = diinginkan

stash = simpanan

flick = mengibaskan

flimsy = ringkih

fugitive = buronan

wreckage = puing - puing

erasure = penghapusan

bigot = fanatic

ranter = pengomel

ganged = dikeroyok

lump = benjolan

shun = menjauhi

fetch, snatch = take

humiliate = mempermalukan

reliant = bergantung 

liberate = membebaskan

decommission = penonaktifkan

lethal = mematikan

conflated = bercampur aduk

prying = mencongkel

coil = kumparan

litter, scrap = trash

pinch = jepit

hinder = halangi

inclusive = inklusif

agate = batu akik 

precinct = daerah pemilihan

trajectory = lintasan

wand = tongkat sihir

demure = pendiam

vane = baling - baling

brawl = ribut

appetizers = makanan pembuka

entrees = hidangan Utama

brick = batu bata

mortar = adukan semen

recuperate = healing

crackers = kerupuk

jams = selai

dips, demote = down

bait = umpan

nicks = torehan

curly = keriting

poke = mencolek

roam = berkeliaran

plumber = tukang ledeng

knob = button

waist = pinggang

cape = jubah

tingle = geli

usability= kegunaan

bounce = pantul

grit = menggertakkan

narrow = sempit

slab = lempengan

lend = borrow

sage, discretion = wisdom

range = jangkauan

flank = mengapit

toast = roti panggang

consent = permit

auction = lelang

pupil = student

feasibility = possibility

snob = sombong

bush = semak

wizard = penyihir

wand = tongkat sihir

inexpensive = cheap

blurry = escape

compelling = interesting

assistive = helping

compliant = patuh

dull = boring

outcome = result

ribbon = pita

reinforcement = bala bantuan

counterfeit = fake

compile = arrange

steady = balance

cadence = irama

clever = smart

sparingly = hemat

desensitized = tidak peka

exceded = melebihi

adhesive = perekat

legging = celana ketat

elicit = earn

inability = ketidakmampuan

countless = tak terhitung

sprout = grow

ground = land

refrigerator = lemari es

ballot = pemungutan suara

fraction = pecahan

quilting = tailor

exclamation = seruan

underlying = yang mendasari

beverage = minuman

grinning = menyeringai

novice = beginner

invaluable = tak ternilai

compose = arrange

succinct = ringkas

imply = menyiratkan

inseparable = tak terpisahkan

cast = pemeran

hefty = besar dan kuat

appeal = pull

interchangeably = secara bergantian

unearth = mengungkap

clutch = mencengkeram

flesh = meat

kidney = ginjal

punitive = menghukum

advent = kedatangan

bulk = massal

miniscule = sangat kecil

swelled = membengkak

whims = keinginan

compel = force

insulated = terisolasi

inward = batin

attainable = dapat dicapai

stale = basi

bleed = berdarah

distrust = unbeliever

nourist = memelihara

refract = pembiasan

promiscuity = pergaulan bebas

ponder = merenungkan

abode = tempat tinggal

atrocity = kekejaman

bigotry = kefanatikan

inanimate = benda mati

provision = ketentuan

cheque = cek

witty = cerdas

tees = kaos

grocery = bahan makanan

issuance = penerbitan

abridge = membatasi

flies = lalat 

salt = garam

stumped = buntu

lingering = berlama - lama

conduit = saluran

equip = melengkapi

futive = future

oblivion = terlupakan

coronation = penobatan

coup = kudeta

fridge = kulkas

fringe = pinggiran

infliction = suffering

deflect = membelokkan, mengalihkan

justify = membenarkan

clobbered = dihajar

adulterate = memalsukan

depose = menggulingkan

fess up = mengaku

cremate = mengkremasi

wriggle = menggeliat

indefensible = tidak dapat dipertahankan

dispel = menghilangkan

vociferous = berisik

poised = tenang

succulent = segar

glisten = berkilau

brimming = menguap

rejoice = bersuka cita

rootless = tak berakar

progeny = keturunan

unprovoked = tidk beralasan

hesitation = ragu - ragu

anxious = cemas

disposal = pembuangan

taunt = mengejek

ravage, ramage, raze, tamper, decimate, vandalism, ruin, devastation, breaking up, demolish, deface = destroy

bashing = mencaci maki

culmination = puncak

ordain = ditahbiaskan

concession = konsesi

disprovable = dapat dibantah

insincerity = ketidaktulusan

fuse = dry

inticacies = kerumitan

fin = sirip

silk = sutra

warmonger = penghasut perang

protracted = berlarut - larut

whirlwind = pusaran air

aqueduct = saluran air

diluting = mengencerkan

reprisal = revenge

culminate = peak

preempting = mendahului 

flotilla = armada

chewing = mengunyah

snuffed = padam

audacity = keberanian

staggering = mengejutkan

crib = buaian

swerve = menyimpang

futile = sia - sia

unprecedented = belum pernah terjadi sebelumnya

attrition = gesekan

donkey = keledai

bush = semak

connivance = persekongkolan

awe = awesome

perpetrator = pelaku

warp = melengkung 

wretched = malang

bracing = menguatkan

gem = permata

equivalance = padanan kata

dugeon = penjara Bawah tanah

snuggle = berpelukan

rage = amukan

tide = pasang surut

possessed = kerasukan

knel, knelt = berlutut

fade = memudar

slash = menebas

malignant = ganas

arc = busur

rigged = dicurangi

abhorrent = menjijikan

legitimate = sah

baggage = barang bawaan

raked = disapu

dissident = pembangkang

apprehending = menangkap

pale = pucat

fared = fate

conscious = aware

incur = mendatangkan

slumble = merosot

mulling = merenungkan 

strain = ketegangan

cope = mengatasi

resurgence = kebangkitan

juncture = persimpangan

repugnant = menjijikkan

fruition = result

beachhead = tempat berpijak

arbitrary = sembarangan / sewenang - wenang

straightedges = penggaris

opposite = berlawanan

observe = mengamati

shouting = berteriak

prevention = pencegahan

tased = diestrum

blare = loud song

shepherd = gembala

grooves = alur

pursuant = sesuai

contentious = kontroversial

signage = rambu

queue = antri

gowns = gaun 

negligence = kelalaian 

Adjournment, defer = postpone

gargling = berkumur 

dirt = semak belukar

ferocity = keganasan

midst = middle

shoroes = beach

pathetically = menyedihkan

alluded = disinggung

ragging = pencabulan

duly = sepatutnya

semblance = kemiripan

condense = mengembun

beefing = daging sapi

enshrined = diabadikan

excavation = penggalian

immaculately = tampa cela

reindeer = rusa kutub

conquest = penaklukan

surrogate = replacement

flank = mengapit

outskirt = pinggiran kota

defect = cacat

insatiable = tak pernah puas

delve = menyelidiki

guild = serikat

auxiliary = maid

tame = jinak

rendezvous = tempat pertemuan

presume = mengandaikan

slippery = licin

fell = fall

lucractive = menguntungkan

ripped = dirobek

regal = agung

acrocity = kekejaman

offshore = lepas pantai

disenchanted = kecewa

impure = tidak murni

treasonous = pengkhianat

dustbin = tempat sampah

crescent = bulan sabit

renowned = famous

itching = gatal

indemnified = dibebaskan

vehicle = kendaraan

discern = membedakan

curbside = pinggir jala

discharge = pelepasan

expunged = deleted

emplaced = ditempatkan

untangle = mengurai

littering = membuang sampah

blading = pisau tajam

tray = baki

denote = menunjukkan

theft = pencurian

engrave = mengukir

ridge = punggung bukit

otters = berang - berang

pearl = Mutiara

magnified = diperbesar

rendezvous = meeting

spurred = memacu

tummel = perut buncit

snare = jerat 

wasp = tawon

bridesmaid = pengiring pengantin perempuan

captivate = menawan

victim = korban

deduce = menyimpulkan

condescending = merendahkan

emulate = meniru

sham = pura - pura

chuckle = tertawa kecil 

bridge = jembatan

vigilante = main hakim sendiri

pernicious = merusak

peddle = mengayuh

wrist = pergelangan tangan

deluded = tertipu

flirtatious = genit

grievance = keluhan

asshole = bajingan

forehead = dahi.

detention = penahanan

vulture = burung bangkai

feigning = berpura - pura 

entrust = menitipkan

gullible = mudah tertipu

whip = cambuk

herse = mobil jenazah

shady = teduh

sewers = selokan

elf = peri

jolly = riang

undercroft = kolong rumah

squeak = mencicit

mice = rat

impaled = tertusuk

rageful = marah

cartridges = peluru

fugitive = buronan

bugle = terompet

cultist (sebutan untuk penganut aliran sesat)

contend = debate

desecration = penodaan 

acute = akut

snarling = menggeram

rampage = mengamuk

stowage = storage

fist = kepalan

fortify = memperkuat

peel = kupas

cramped = sempit

saddle = pelana

scourge = cambuk

draped = terbungkus

mutine = memberontak

razor = pisau cukur

slick = licin

haste = bergegas

inhabit = menghuni

feud = perseteruan

damage = rusak

cradle = buaian

stoic = tabah

steam = uap

heap = tumpukan

cranking = menghidupkan

astound = menakjubkan

flair = bakat

snickering = cekikikan

frail = lemah

bleating = mengembik

exclaim = berseru

repercussion = gema

puncture = tusukan

inflatable = dapat digelembungkan

vigilantism = kekerasan

rustle = gemerisik

toes = jari kaki. 

abusive, haul = kasar

gauldy = norak 

inconsolable = tidak dapat dihibur

pacifying = menenangkan

corny = dangkal

suspend = menangguhkan

severed = memutus

aiding = helping

mend = fixing

whining = merengek

banging = membentur

evicted = diusir

indestructible = tidak dapat dihancurkan

hive = sarang lebah

morphed = berubah bentuk

faucet = keran

plushies = boneka

breezy = semilir

naggy = cerewet 

nag = mengomel

dwilded = menjadi liar

rave = mengoceh

disprove = membantah

hawker = penjaja

barking = menggonggong

curtin = tirai

teetering = goyah

demonic = evil

mate = friend

clatter = berisik

crown = mahkota

disorient = bingung

perk = kegembiraan

gasp = terkesiap

shudder = menggigil

heartance, blare = suara keras

extrajudicial = diluar hukum

groan = mengerang

humidity = kelembaban

mumble = begumam

dashing = gagah

dash = lari cepat

scramble = berebut

demonize = menjelek - jelekkan

reliance = ketergantungan / kepercayaan

immortal = abadi

disintegrate = hancur

bulking = membesar

strides = Langkah maju

skull = tengkorak

haughty = sombong

wrench = kunci inggris

bloat = kembung

smirking = menyeringai

gleant = berkilau

obliterate = melenyapkan

deplated = terkuras

bearer = pembawa

immerse = membenamkan

braided = dikepang

incriminate = memberatkan

planter = penanam

illicit = haram

hunch = firasat

dismissive = meremehkan

compassionate = penuh kasih

perched = bertengger

rouse = membangkitkan

sundered = terpisah

conjure = menyulap

fraying = mengurai

cane = tongkat

arcane = misterius

squandered = disia-siakan

primordial = purba

shrug = mengangkat bahu

forebonding = firasat

fread = menakutkan

absolve = membebaskan

slipping = tergelincir 

wagon = kereta

thrilling = mendebarkan

cavern = cave

immature = belum dewasa

slither = meluncur

lagging = tertinggal

exhibit = pameran

hover = melayang

diverged = menyimpang

garnished = dihiasi

obnovious = menjengkelkan

gusting = berembus kencang

levitating = melayang

douse = menyiram

irresistible = sangat menarik

dissipate = missing

equate = menyamakan

verbose = bertele - tele

uncharted = belum dipetakan

gist = core

madder = lebih marah

vetting = pemeriksaan

adjacent = bersebelahan

lash = bulu mata / cambukan

adorn = menghiasi

jabbering = mengoceh

prick = menusuk

lubricate = melumasi

slaught = membantai

fissionable = yang dapat dipecah

lucrative = menguntungkan

hone = mengasah

possess = having

turn = kotoran 

slurp = menyeruput

scant = little

triage = perawatan

bark = kulit kayu

decisive = tegas

dealt = ditangani

disclosure = pengungkapan

vanity = kesombongan

embroil = melibatkan

tucked = terselip

revert = back

amicable = ramah tamah

adjecement = keterikatan

fertility = kesuburan

glam up = berdandan

edict = perintah

devolve = menyerahkan

unparsable = tidak dapat diuraikan

rectify = fixing

filthy = kotor

Elective = choice

splattered = berceceran

thus = dengan demikian

horde = gerombolan

deciduous = berganti

lashing = cambukan

foreground = latar depan

sniffing = mengendu

spin span spun

tardy = late

cliched =klise

restrain = menahan

seweged = disalurkan

topple = menjatuhkan

ditty = lagu pendek

incurred = happen

recitation = pembacaan

waged = dilancarkan

relinquish = melepaskan

rupture = pecahnya

exacerbation = memperburuk

exterminate = memusnahkan

perennially = forever

baffle = membingungkan

cucked = ditipu

tremble = gemetar

Miscellaneous = beraneka ragam

intrusive = annoying

leaper = pelompat

stem = batang

breast = chest

perk = merembes

reprise = repeat

defuse = redakan

defrost = mencairkan

lit up = menyala

straight = lurus

heck = sial

exorcism = pengusiran setan

crammed = penuh sesak

astounding = menakjubkan

mischief = kerusakan

rot = membusuk

blimp = balon Udara

lash out = attacking

infiltrate = menyusup

seduction = bujukan

tranquil = peace

reuse = penggunaan ulang

blight = penyakit busuk.

steed = horse

unful = unsatisfaction

clarity = kejelasan

astonish = mencengangkan

stitch = jahitan

banded = terikat

defecate = buang air sembarangan

walled = berdinding

hoard = timbunan

tossing, hurl = throw

morron = stupid

foliage = leaf

burgundy = merah anggur

elbow = siku

champ = winner

renege = decide

commiserate = menaruh simpati

eve = night

winking = mengedipkan mata

mount = mountain

ingrain = tertanam

shutter = rana

vanquish = conquer

stunt = mengerahkan

acquaintance = kenalan

permeates = meresap

revamp = perombakan

pounded = ditumbuk

ignorance = unknown

latrine = jamban

breeding = pembiakan

wolly = berburu

hound = dog

embattled = berjuang

swept = tersapu

mistress = nyona

backlash = serangan balik

veal = daging sapi muda 

crochet = merenda

deceit = tipu daya

enchoed = saved

wench = girl

sickle = sabit

deprival = kekurangan

indebted = berhutang

arbitrary = sewenang - wenang

piety = kesalehan

custody = hak asuh

snooze = tidur sebentar

varsity = university

shelf = rak

flagrance = menyolok

crail = merayap

palisades = pagar kayu

vindictive = pendendam

ascent = pendakian

nuanced = nuansa

overuse = penggunaan berlebihan

assert = penegasan

insurgent = pemberontak

desert = gurun

drip = menetes

wary = be careful

sprinkle = taburan 

numbness = matirasa 

starch = pati

broth = kaldu

incline = lereng

airfare = tiket pesawat

inhibitor = penghambat

dissected = dibedah

dissolve = larut

clinging = melekat

bered = revolt

fearsome = menakutkan

captor = kidnapper

fiercy = garang

hitch = halangan

grind = menggiling

cluthing = mencekam

greet = menyapa

deplorable = menyedihkan

usher = pengantar

moisture = kelembapan

contiguous = bersebelahan

putative = dugaan

adage = pepatah

impasse = jalan buntu

precursor = pendahulu

meddling = campur tangan

porch = beranda

severely = parah

dissemination = penyebaran

mound = gundukan

complicity = keterlibatan

vilified = difitnah

spook = menakuti

fare = tarif

greasy = berminyak

intruder = pengacau

peas = kacang polong

tread = tapak

unleash = melepaskan

fear = scary

startling = mengejutkan

proficient = expert

collide = bertabrakan

towed = ditarik

ingenuity = kecerdikan

crept = merayap

neglect = mengabaikan

scabies = kudis

harnesses = memanfaatkan

ray, illuminate = light

morgue = kamar mayat

plague = wabah

thwarted = digagalkan

feeble = weak

famine = kelaparan

glimmer = kilauan

wickling = mengerut

glued = direkatkan

mistreated = dianiaya

radist = lobak

oddsb = possibility

meritless = tak berdasar

defamation = pencemaran nama baik. 

liberation = pembebasan

discourse = wacana

rejuvenation = peremajaan

indeterminate = tak tentu

shrounding = menyelubungi

stanting = said

examinate = memeriksa

impeach = mendakwa

pillaging = penjarahan

egregiously = sangat parah

utterly = sepenuhnya

intrusion = annoying

infested = dihinggapi

reprieve = penangguhan hukuman.

inundated = tergenang

gestate = mengandung

fetishizing = mengagung-agungkan

impervious = kebal

foil = menggangalkan

confusion = kebingungan

shrine = kuil 

inverness = keterbalikan

commotion = keributan

imperious = angkuh

flatten = meratakan

commendable = patut dipuji

glaze = dilapisi

sewage = limbah

kindle = menyalakan

lewdness = dirty

righteous =fair

pertinent = bersangkutan

pervade = meliputi

subbed = diganti

smacked = menampar

herald = inform

insurrection = agains

ramming = menabrak

unfurl = membentangkan

periphery = pinggiran

jubilation = happiness

grove = small forest

perpetual = eternal

goosebump = merinding

swiftly = dengan cepat

euthanized = disuntik mati

obstructing = menghalangi

enforcement = penegakan hukum

satire = sindiran

stating = saying

faction = faksi

demeanor = sikap

exclude = except

custodian = care

plaid = kotak - kotak

perilously = dangerous

feverishly = dengan tergesa - gesa

languishing = merana

conscience = hati Nurani

avalanche = salju longsor

levy = tax

benevolent = penuh kebajikan

ostracised = dikucikan

inquisition = penyelidikan

bloom = flower

avail = faedah

warden = sipir

folklore = cerita rakyat

vessel = sail

intermittent = berselang

opted = memilih

suffice = enough

nursery = pembibitan

renancement = pembaharuan

outsmart = mengakali

deviate = menyimpang

lather = busa

subbing = penggantian

inquest = checking


